-S-******
**------*
*-**-**--
*------*-
********-
-----*---
-*-***-**
-*--*---*
--*---***
*--***---
**-----*F