****************************
*-----S-----*---**---**-****
*-*********---*----*----*-**
*---*-----***-******-*-**-**
*-*-***-*---*----**--*--*--*
*-*---*-*-***-**----***-**-*
*-***-*-*-----*--**--**----*
*---*-*-***-***-****--***-**
*****-*--*--*---*****-**--**
*-----**-*-********---*--***
*-*****--*--**---***-*--****
*---*---********-**----**-**
**-*************----**-**-**
**-****---****---**---**--**
**--****-****--*-****---*--*
***-****-**---**-**---*---**
*---***--****-*****-***-****
**-*****-***---*-----**---**
*--*****---***---***-****-**
*******************--**F--**